0000010000000000
0000000000000000
0000000000000000
0000010000000000
0000010000000000
0000010000000000
0011111100000000
0000010100000000
0000000100000000